03  oae 15 
25  kem 21 
15  oat 32 
29  kem 04 
19  02  eet
12  oat 28 
04  18  eet
29  oat 19 
19  kem 01 
21  14  eet
29  oat 02 
01  oae 14 
32  kem 24 
18  kem 33 
07  kem 13 
30  oae 27 
20  oat 08 
32  oat 01 
09  oat 02 
23  oat 13 
09  oat 01 
18  26  eet
30  kem 28 
05  oat 28 
13  oat 24 
11  kem 08 
11  kem 09 
31  kem 18 
05  oae 26 
33  oat 04 
08  kem 02 
12  oae 09 
27  oae 14 
25  oat 21 
03  oat 16 
17  kem 27 
19  kem 32 
07  oat 09 
24  kem 09 
09  23  eet
26  oae 08 
27  23  eet
01  02  eet
10  kem 17 
29  kem 12 
06  15  eet
28  kem 05 
20  oat 12 
25  oat 28 
02  kem 13 
03  oat 15 
26  oat 28 
21  oae 20 
16  kem 24 
18  08  eet
11  oat 06 
10  kem 29 
11  04  eet
14  oat 27 
18  oae 10 
16  oae 26 
27  oat 21 
31  oat 18 
02  oat 15 
19  oae 01 
12  kem 08
27  oae 03 
24  oat 21 
01  kem 06 
23  oat 07 
07  kem 05 
02  oat 06 
30  kem 10 
06  oat 01 
33  oat 31 
13  oat 28 
03  oat 14 
21  13  eet
32  kem 17 
26  oat 19 
28  oae 26 
28  04  eet
01  04  eet
19  13  eet
16  23  eet
20  kem 12 
14  kem 03 
13  oat 09 
22  13  eet
31  04  eet
21  08  eet
07  kem 22 
19  oae 06 
25  oat 10 
18  03  eet
10  oae 27 
14  oae 26 
29  oae 33 
24  23  eet
09  oat 11 
31  kem 26 
16  oae 11 
18  oae 24 
23  oat 30 
01  oae 29 
22  23  eet
10  03  eet
18  oae 28 
08  oat 25 
20  kem 29 
24  oat 11 
14  oat 17 
11  13  eet
09  oae 14 
18  oae 05 
16  oat 09 
19  oat 21 
30  kem 17 
13  oat 16 
33  oat 25 
01  kem 05 
33  oat 10 
19  15  eet
27  oat 17 
17  oat 11 
22  16  eet
30  oat 27 
10  kem 12 